Name,Volume,Ask Size,Ask Price,Bid Size,Bid Price,Last Price,Shares Matched,Shares Routed
UVXY,1455576,0,0.00,0,0.00,2.27,1436862,18714
VIXY,981556,0,0.00,0,0.00,5.70,970808,10748
UVIX,866891,0,0.00,0,0.00,5.94,852743,14148
IEFA,812689,0,0.00,0,0.00,66.77,808308,4381
VXX,787389,0,0.00,0,0.00,28.40,782627,4762
USMV,393195,0,0.00,0,0.00,72.28,392735,460
CBOE,304097,0,0.00,0,0.00,138.35,301146,2951
ITB,287156,0,0.00,0,0.00,78.91,277273,9883
USHY,284353,0,0.00,0,0.00,35.09,276833,7520
CSM,253141,0,0.00,0,0.00,49.44,253141,0
QUAL,233158,0,0.00,0,0.00,129.33,231073,2085
ARKG,214499,0,0.00,0,0.00,33.39,212305,2194
GOVT,191100,0,0.00,0,0.00,22.96,163263,27837
AAAU,190242,0,0.00,0,0.00,19.53,186839,3403
SVXY,172256,0,0.00,0,0.00,79.49,171456,800
INDA,167330,0,0.00,0,0.00,41.85,166313,1017
EFV,137752,0,0.00,0,0.00,48.20,134283,3469
SVIX,115803,0,0.00,0,0.00,24.78,114497,1306
EZU,115208,0,0.00,0,0.00,44.22,113688,1520
IGV,115074,0,0.00,0,0.00,330.26,114969,105
VUSB,101595,0,0.00,0,0.00,48.99,101233,362
MOAT,95097,0,0.00,0,0.00,77.40,94700,397
COWZ,91608,0,0.00,0,0.00,46.65,86374,5234
ICSH,80613,0,0.00,0,0.00,50.14,80613,0
BBJP,44439,0,0.00,0,0.00,51.71,41750,2689
IDV,43165,0,0.00,0,0.00,26.46,43065,100
VNM,42875,0,0.00,0,0.00,13.01,42875,0
EEMV,42744,0,0.00,0,0.00,55.28,39950,2794
FLOT,42596,0,0.00,0,0.00,50.60,42596,0
ARKQ,41412,0,0.00,0,0.00,53.51,41376,36
ACWV,39955,0,0.00,0,0.00,96.98,38638,1317
OMFL,39694,0,0.00,0,0.00,47.52,39593,101
NOBL,38604,0,0.00,0,0.00,91.90,38304,300
PAVE,37648,0,0.00,0,0.00,29.53,34962,2686
ITA,37330,0,0.00,0,0.00,114.70,37292,38
REM,37199,0,0.00,0,0.00,22.42,37197,2
ECH,35358,0,0.00,0,0.00,29.23,32145,3213
MTUM,34739,0,0.00,0,0.00,138.06,33930,809
BBEU,33925,0,0.00,0,0.00,54.04,32474,1451
RMIF,33307,0,0.00,0,0.00,25.02,33307,0
WTAI,33137,0,0.00,0,0.00,18.72,30642,2495
BBCA,33050,0,0.00,0,0.00,60.14,29550,3500
HEFA,32800,0,0.00,0,0.00,30.55,28788,4012
VLUE,32002,0,0.00,0,0.00,91.70,31450,552
IAGG,31775,0,0.00,0,0.00,49.07,31760,15
JMST,30799,0,0.00,0,0.00,50.56,29478,1321
BUYW,30708,0,0.00,0,0.00,13.48,30708,0
EMGF,28794,0,0.00,0,0.00,41.77,25304,3490
FDG,27801,0,0.00,0,0.00,63.60,27801,0
TLTW,27097,0,0.00,0,0.00,33.19,27032,65
BOXX,26031,0,0.00,0,0.00,102.08,26031,0
ICF,25598,0,0.00,0,0.00,54.49,25598,0
HYD,25554,0,0.00,0,0.00,51.01,25432,122
NEAR,25490,0,0.00,0,0.00,49.56,25490,0
PJUN,25112,0,0.00,0,0.00,31.11,20473,4639
RDVI,24869,0,0.00,0,0.00,21.82,24769,100
XJUN,24400,0,0.00,0,0.00,33.19,24400,0
CNYA,23618,0,0.00,0,0.00,29.53,23118,500
KNG,23428,0,0.00,0,0.00,51.65,23428,0
CALF,23377,0,0.00,0,0.00,39.48,23355,22
IBHD,23084,0,0.00,0,0.00,22.99,16320,6764
IFRA,22012,0,0.00,0,0.00,38.07,22012,0
BBAX,21978,0,0.00,0,0.00,48.53,20478,1500
BUFR,21782,0,0.00,0,0.00,24.39,21782,0
EFG,21770,0,0.00,0,0.00,94.18,21770,0
EFAV,21619,0,0.00,0,0.00,67.25,21552,67
IYZ,20321,0,0.00,0,0.00,21.42,20297,24
ENOR,20006,0,0.00,0,0.00,22.31,19806,200
HEGD,19300,0,0.00,0,0.00,18.08,19300,0
SMB,19203,0,0.00,0,0.00,16.77,19203,0
ESGV,17990,0,0.00,0,0.00,75.72,17857,133
QDEC,16206,0,0.00,0,0.00,22.00,16206,0
IQDG,15666,0,0.00,0,0.00,33.96,9672,5994
IGE,15523,0,0.00,0,0.00,38.43,15523,0
ARKX,15140,0,0.00,0,0.00,14.33,13274,1866
FBCG,14521,0,0.00,0,0.00,28.44,14421,100
IYT,14203,0,0.00,0,0.00,232.10,14203,0
BBUS,13860,0,0.00,0,0.00,77.24,13566,294
PICK,13835,0,0.00,0,0.00,40.23,13760,75
PBUS,13345,0,0.00,0,0.00,42.86,13345,0
PNOV,12981,0,0.00,0,0.00,33.07,12981,0
POCT,12960,0,0.00,0,0.00,32.92,12960,0
NULG,12902,0,0.00,0,0.00,59.44,12683,219
SPYI,12375,0,0.00,0,0.00,49.48,12071,304
DIVB,12341,0,0.00,0,0.00,37.22,12263,78
DFIC,12311,0,0.00,0,0.00,24.26,10297,2014
PSFF,11542,0,0.00,0,0.00,23.85,11542,0
JEMA,11301,0,0.00,0,0.00,36.53,11301,0
SLVP,11132,0,0.00,0,0.00,10.31,11112,20
OUSM,10847,0,0.00,0,0.00,35.66,10847,0
DFRA,10481,0,0.00,0,0.00,26.11,10481,0
IEO,10241,0,0.00,0,0.00,84.04,10123,118
NULV,10235,0,0.00,0,0.00,33.67,10235,0
BBIN,10050,0,0.00,0,0.00,54.92,10050,0
PTLC,9988,0,0.00,0,0.00,39.93,9688,300
GCOW,9926,0,0.00,0,0.00,33.20,9926,0
UAPR,9832,0,0.00,0,0.00,25.61,9832,0
SYLD,9755,0,0.00,0,0.00,58.87,9655,100
LVHI,9536,0,0.00,0,0.00,26.86,9431,105
ITM,9514,0,0.00,0,0.00,45.80,9514,0
FRDM,9485,0,0.00,0,0.00,31.72,9485,0
ICVT,9283,0,0.00,0,0.00,74.19,9183,100
XJH,9145,0,0.00,0,0.00,34.41,9145,0
SMMD,9120,0,0.00,0,0.00,56.10,9120,0
ICOW,8853,0,0.00,0,0.00,29.69,8853,0
BUFD,8801,0,0.00,0,0.00,21.07,8801,0
SMAY,8774,0,0.00,0,0.00,20.63,8374,400
UMAY,8493,0,0.00,0,0.00,27.47,8493,0
CEFS,8369,0,0.00,0,0.00,18.22,8369,0
PTMC,8315,0,0.00,0,0.00,31.81,8015,300
LQDI,8226,0,0.00,0,0.00,25.39,8226,0
MFUL,7880,0,0.00,0,0.00,21.67,7880,0
FMAY,7877,0,0.00,0,0.00,38.07,7877,0
ESML,7837,0,0.00,0,0.00,34.86,7837,0
TDV,7634,0,0.00,0,0.00,63.28,7434,200
TMFC,7378,0,0.00,0,0.00,39.04,7050,328
OMFS,7193,0,0.00,0,0.00,36.01,7193,0
JMUB,6989,0,0.00,0,0.00,49.97,6989,0
TAIL,6612,0,0.00,0,0.00,13.90,6612,0
SMOT,6608,0,0.00,0,0.00,28.94,6608,0
FLQM,6602,0,0.00,0,0.00,43.33,6602,0
FGRO,6424,0,0.00,0,0.00,16.27,6373,51
PJAN,6119,0,0.00,0,0.00,34.44,6119,0
DIHP,6107,0,0.00,0,0.00,24.28,6007,100
HYMU,6041,0,0.00,0,0.00,21.54,6041,0
FLQL,6012,0,0.00,0,0.00,43.24,6012,0
VIXM,5859,0,0.00,0,0.00,22.30,5859,0
JCPB,5712,0,0.00,0,0.00,46.58,5562,150
DDLS,5627,0,0.00,0,0.00,31.78,5098,529
PRNT,5493,0,0.00,0,0.00,22.80,5493,0
VSGX,5114,0,0.00,0,0.00,53.33,5114,0
SHYD,5035,0,0.00,0,0.00,22.12,5034,1
FAPR,5007,0,0.00,0,0.00,32.07,5007,0
IBHG,4975,0,0.00,0,0.00,21.71,4700,275
FLBL,4956,0,0.00,0,0.00,23.45,4956,0
GVAL,4790,0,0.00,0,0.00,20.57,4790,0
XBAP,4775,0,0.00,0,0.00,28.53,4775,0
JUCY,4433,0,0.00,0,0.00,24.74,4369,64
IZRL,4307,0,0.00,0,0.00,18.79,4307,0
GMAY,4281,0,0.00,0,0.00,30.67,4281,0
REGL,4236,0,0.00,0,0.00,70.60,4169,67
FJUN,4111,0,0.00,0,0.00,40.07,4111,0
EDEN,4073,0,0.00,0,0.00,105.42,4073,0
NUDM,4057,0,0.00,0,0.00,28.83,4057,0
NANC,4051,0,0.00,0,0.00,26.85,4051,0
DFIS,4022,0,0.00,0,0.00,23.01,4022,0
FYLD,4017,0,0.00,0,0.00,24.57,3727,290
NUMG,3995,0,0.00,0,0.00,37.44,3295,700
BUYZ,3867,0,0.00,0,0.00,25.01,3867,0
FBCV,3817,0,0.00,0,0.00,27.72,3817,0
SMMV,3809,0,0.00,0,0.00,34.30,3786,23
PSMG,3734,0,0.00,0,0.00,16.68,3734,0
QMAR,3656,0,0.00,0,0.00,23.55,3556,100
HEEM,3581,0,0.00,0,0.00,24.53,3581,0
JULZ,3574,0,0.00,0,0.00,34.50,3574,0
DISV,3436,0,0.00,0,0.00,23.94,3436,0
OUSA,3433,0,0.00,0,0.00,42.58,3433,0
TRTY,3325,0,0.00,0,0.00,24.66,3325,0
NUSC,3261,0,0.00,0,0.00,36.44,3261,0
IBHE,3174,0,0.00,0,0.00,22.78,3156,18
PMAR,3126,0,0.00,0,0.00,33.17,3126,0
MOTI,3084,0,0.00,0,0.00,31.55,3084,0
FPFD,3076,0,0.00,0,0.00,20.12,3076,0
EYLD,3047,0,0.00,0,0.00,29.05,2247,800
GSUS,3042,0,0.00,0,0.00,58.70,3042,0
NUEM,3013,0,0.00,0,0.00,27.50,3013,0
MEAR,2980,0,0.00,0,0.00,49.81,2980,0
UJUN,2964,0,0.00,0,0.00,28.18,2764,200
DFNV,2836,0,0.00,0,0.00,24.50,2836,0
TMFG,2799,0,0.00,0,0.00,25.78,2799,0
WFHY,2777,0,0.00,0,0.00,44.16,2777,0
QVAL,2763,0,0.00,0,0.00,33.66,2763,0
MOHR,2726,0,0.00,0,0.00,19.46,2726,0
IBHF,2723,0,0.00,0,0.00,22.61,2723,0
DDEC,2707,0,0.00,0,0.00,33.21,2607,100
LQDW,2706,0,0.00,0,0.00,33.37,2706,0
QJUN,2669,0,0.00,0,0.00,22.01,2584,85
AESR,2628,0,0.00,0,0.00,12.43,2418,210
IETC,2622,0,0.00,0,0.00,52.68,2622,0
KAPR,2606,0,0.00,0,0.00,27.29,2228,378
RSEE,2597,0,0.00,0,0.00,26.04,2597,0
FSEP,2559,0,0.00,0,0.00,36.83,2559,0
HYGW,2559,0,0.00,0,0.00,35.50,2547,12
GAPR,2525,0,0.00,0,0.00,30.53,525,2000
DAPR,2519,0,0.00,0,0.00,30.22,2519,0
MDLV,2502,0,0.00,0,0.00,23.86,2502,0
DDWM,2500,0,0.00,0,0.00,31.45,2500,0
VFVA,2494,0,0.00,0,0.00,98.49,2494,0
PDEC,2489,0,0.00,0,0.00,32.42,2489,0
IGHG,2466,0,0.00,0,0.00,71.52,2466,0
BJUL,2414,0,0.00,0,0.00,34.09,2414,0
VAMO,2359,0,0.00,0,0.00,25.20,2359,0
DRSK,2340,0,0.00,0,0.00,24.91,2340,0
PMAY,2331,0,0.00,0,0.00,29.25,2331,0
NJUL,2308,0,0.00,0,0.00,50.88,1008,1300
UAUG,2282,0,0.00,0,0.00,27.87,2282,0
HYDB,2243,0,0.00,0,0.00,44.45,2243,0
XDEC,2233,0,0.00,0,0.00,32.31,2233,0
BBHY,2232,0,0.00,0,0.00,44.35,2232,0
CEMB,2204,0,0.00,0,0.00,43.14,2204,0
BUFG,2202,0,0.00,0,0.00,19.72,2202,0
IYJ,2177,0,0.00,0,0.00,101.23,2177,0
XBJA,2136,0,0.00,0,0.00,24.29,2136,0
SMIN,2127,0,0.00,0,0.00,55.36,2126,1
DNOV,2097,0,0.00,0,0.00,35.48,2097,0
XSEP,2071,0,0.00,0,0.00,33.54,2071,0
ZIVB,2003,0,0.00,0,0.00,17.47,2003,0
UMAR,2002,0,0.00,0,0.00,29.58,2002,0
PSEP,1983,0,0.00,0,0.00,31.83,1983,0
NETZ,1972,0,0.00,0,0.00,50.28,1972,0
OILK,1972,0,0.00,0,0.00,40.07,1972,0
FSMO,1963,0,0.00,0,0.00,20.92,1963,0
OGIG,1931,0,0.00,0,0.00,31.37,1931,0
BALT,1866,0,0.00,0,0.00,27.75,1866,0
XMPT,1853,0,0.00,0,0.00,21.01,1853,0
NUMV,1838,0,0.00,0,0.00,28.79,1838,0
FLIA,1824,0,0.00,0,0.00,19.63,1824,0
IBMM,1793,0,0.00,0,0.00,25.67,1793,0
SVAL,1786,0,0.00,0,0.00,26.85,1786,0
TMFM,1739,0,0.00,0,0.00,22.94,1739,0
IBMP,1736,0,0.00,0,0.00,24.99,1736,0
DAUG,1708,0,0.00,0,0.00,33.04,1708,0
IBMO,1698,0,0.00,0,0.00,25.10,1698,0
PAUG,1669,0,0.00,0,0.00,30.28,1669,0
PWS,1660,0,0.00,0,0.00,26.73,1560,100
SMDV,1658,0,0.00,0,0.00,60.74,1658,0
PBEE,1654,0,0.00,0,0.00,22.48,1654,0
FOCT,1632,0,0.00,0,0.00,36.56,1632,0
IBHC,1614,0,0.00,0,0.00,23.56,1206,408
USMF,1554,0,0.00,0,0.00,37.75,1554,0
HFGO,1542,0,0.00,0,0.00,14.86,1542,0
RTAI,1537,0,0.00,0,0.00,20.29,1537,0
GMOM,1535,0,0.00,0,0.00,27.78,1535,0
SNAV,1517,0,0.00,0,0.00,26.45,1517,0
VXZ,1508,0,0.00,0,0.00,19.08,1480,28
FJUL,1504,0,0.00,0,0.00,37.67,1504,0
UJUL,1483,0,0.00,0,0.00,28.38,1483,0
RULE,1469,0,0.00,0,0.00,19.60,1469,0
FCPI,1451,0,0.00,0,0.00,32.14,1451,0
MPRO,1400,0,0.00,0,0.00,25.72,1400,0
BUFT,1387,0,0.00,0,0.00,19.59,1387,0
GAA,1382,0,0.00,0,0.00,26.77,1382,0
TTAI,1366,0,0.00,0,0.00,26.65,1366,0
TMAT,1350,0,0.00,0,0.00,14.40,1250,100
SECT,1348,0,0.00,0,0.00,42.19,1148,200
SATO,1341,0,0.00,0,0.00,7.19,951,390
DWLD,1338,0,0.00,0,0.00,28.19,1338,0
IBMN,1338,0,0.00,0,0.00,26.24,1338,0
GSEW,1308,0,0.00,0,0.00,60.66,1308,0
IBHH,1303,0,0.00,0,0.00,22.47,1303,0
FLHY,1280,0,0.00,0,0.00,22.64,1280,0
GSST,1269,0,0.00,0,0.00,49.76,1269,0
XVV,1262,0,0.00,0,0.00,32.55,1262,0
FJAN,1220,0,0.00,0,0.00,36.26,1220,0
OEUR,1191,0,0.00,0,0.00,27.51,1191,0
IDUB,1180,0,0.00,0,0.00,19.97,1180,0
EGIS,1178,0,0.00,0,0.00,34.89,1178,0
RSBT,1149,0,0.00,0,0.00,18.05,1149,0
BAUG,1147,0,0.00,0,0.00,32.57,1147,0
BBRE,1144,0,0.00,0,0.00,84.03,1144,0
DURA,1140,0,0.00,0,0.00,31.20,1140,0
PSFJ,1100,0,0.00,0,0.00,22.95,1100,0
DFEB,1076,0,0.00,0,0.00,34.68,1076,0
BUFF,1044,0,0.00,0,0.00,37.00,1044,0
EAOA,1039,0,0.00,0,0.00,30.18,1039,0
XBTF,1038,0,0.00,0,0.00,26.14,1038,0
NURE,1030,0,0.00,0,0.00,30.99,1030,0
TSJA,1028,0,0.00,0,0.00,26.95,1028,0
GVI,1014,0,0.00,0,0.00,103.17,1014,0
GMAR,1002,0,0.00,0,0.00,31.29,1002,0
VOTE,991,0,0.00,0,0.00,50.03,991,0
FCLD,990,0,0.00,0,0.00,18.86,990,0
TSOC,962,0,0.00,0,0.00,30.15,962,0
DMAY,958,0,0.00,0,0.00,33.74,958,0
QLC,948,0,0.00,0,0.00,47.50,848,100
IGRO,939,0,0.00,0,0.00,61.32,939,0
PJUL,902,0,0.00,0,0.00,33.04,902,0
XSHD,897,0,0.00,0,0.00,15.97,896,1
EFAD,880,0,0.00,0,0.00,37.82,880,0
USEP,852,0,0.00,0,0.00,28.56,852,0
IMOM,847,0,0.00,0,0.00,25.47,847,0
QSPT,843,0,0.00,0,0.00,20.83,843,0
FDEC,827,0,0.00,0,0.00,35.06,827,0
TTAC,826,0,0.00,0,0.00,50.72,826,0
PSMJ,822,0,0.00,0,0.00,22.83,822,0
PBND,815,0,0.00,0,0.00,21.90,815,0
EMHY,813,0,0.00,0,0.00,34.61,763,50
FLDR,798,0,0.00,0,0.00,49.85,798,0
MDEV,796,0,0.00,0,0.00,20.14,796,0
ACIO,795,0,0.00,0,0.00,30.47,795,0
FCTR,777,0,0.00,0,0.00,25.63,777,0
EPRF,770,0,0.00,0,0.00,18.51,770,0
VMAT,756,0,0.00,0,0.00,26.42,756,0
LYFE,753,0,0.00,0,0.00,32.12,753,0
MSTB,730,0,0.00,0,0.00,26.60,730,0
DJUN,718,0,0.00,0,0.00,35.67,718,0
IBMQ,718,0,0.00,0,0.00,25.09,718,0
XSHQ,703,0,0.00,0,0.00,34.84,703,0
HIDE,701,0,0.00,0,0.00,23.52,701,0
BSEP,700,0,0.00,0,0.00,33.27,700,0
PAWZ,696,0,0.00,0,0.00,50.24,696,0
IQM,687,0,0.00,0,0.00,47.20,687,0
DJUL,675,0,0.00,0,0.00,33.78,675,0
JCPI,672,0,0.00,0,0.00,46.24,672,0
FAUG,663,0,0.00,0,0.00,37.55,663,0
BNOV,660,0,0.00,0,0.00,32.91,660,0
DALT,656,0,0.00,0,0.00,8.41,656,0
FDRV,653,0,0.00,0,0.00,18.30,653,0
GFEB,645,0,0.00,0,0.00,30.54,545,100
APRJ,637,0,0.00,0,0.00,24.92,637,0
ESG,623,0,0.00,0,0.00,104.78,623,0
YMAR,609,0,0.00,0,0.00,20.95,609,0
HYIN,604,0,0.00,0,0.00,17.93,604,0
BFEB,600,0,0.00,0,0.00,33.34,600,0
RESD,600,0,0.00,0,0.00,28.02,500,100
UDEC,597,0,0.00,0,0.00,29.46,597,0
FNOV,580,0,0.00,0,0.00,39.07,580,0
BDEC,579,0,0.00,0,0.00,35.12,579,0
IGLD,579,0,0.00,0,0.00,19.43,579,0
XUSP,576,0,0.00,0,0.00,27.37,576,0
VCEB,553,0,0.00,0,0.00,61.42,553,0
PEX,548,0,0.00,0,0.00,28.55,506,42
PAPR,535,0,0.00,0,0.00,30.40,535,0
DJAN,523,0,0.00,0,0.00,32.09,523,0
KJAN,520,0,0.00,0,0.00,31.65,520,0
PFEB,518,0,0.00,0,0.00,30.28,518,0
STLG,509,0,0.00,0,0.00,34.94,509,0
FLV,501,0,0.00,0,0.00,58.78,501,0
HSRT,500,0,0.00,0,0.00,38.03,500,0
MAYZ,500,0,0.00,0,0.00,24.63,500,0
SPMV,500,0,0.00,0,0.00,37.32,500,0
VFMF,498,0,0.00,0,0.00,101.12,498,0
INTL,482,0,0.00,0,0.00,21.21,462,20
WEED,482,0,0.00,0,0.00,22.29,482,0
GOVZ,478,0,0.00,0,0.00,13.02,478,0
FMAG,457,0,0.00,0,0.00,20.93,457,0
GTIP,455,0,0.00,0,0.00,49.07,455,0
XTJL,450,0,0.00,0,0.00,27.23,450,0
FFSG,449,0,0.00,0,0.00,32.11,449,0
JPIB,447,0,0.00,0,0.00,46.72,447,0
SJIM,439,0,0.00,0,0.00,24.03,439,0
IGEB,437,0,0.00,0,0.00,43.79,437,0
WLDR,431,0,0.00,0,0.00,25.25,431,0
TYA,430,0,0.00,0,0.00,15.26,430,0
BMAR,425,0,0.00,0,0.00,36.13,425,0
GLOV,415,0,0.00,0,0.00,40.49,15,400
BJAN,414,0,0.00,0,0.00,36.67,414,0
STOT,408,0,0.00,0,0.00,46.38,408,0
APRH,403,0,0.00,0,0.00,25.11,403,0
SHAG,402,0,0.00,0,0.00,46.79,402,0
XMAR,402,0,0.00,0,0.00,31.10,402,0
BMAY,400,0,0.00,0,0.00,31.00,400,0
FMIL,367,0,0.00,0,0.00,32.39,367,0
NAPR,367,0,0.00,0,0.00,41.04,367,0
DFNL,364,0,0.00,0,0.00,26.89,364,0
SPCZ,357,0,0.00,0,0.00,26.40,357,0
MLN,353,0,0.00,0,0.00,17.81,353,0
BUFB,350,0,0.00,0,0.00,25.40,350,0
XDSQ,347,0,0.00,0,0.00,28.24,347,0
HYBL,345,0,0.00,0,0.00,27.61,345,0
FIBR,336,0,0.00,0,0.00,83.83,336,0
QMOM,327,0,0.00,0,0.00,45.58,327,0
MAGA,317,0,0.00,0,0.00,37.88,317,0
FRNW,313,0,0.00,0,0.00,21.12,313,0
OSCV,312,0,0.00,0,0.00,31.58,312,0
FFHG,311,0,0.00,0,0.00,32.64,311,0
UFEB,308,0,0.00,0,0.00,27.32,308,0
DINT,305,0,0.00,0,0.00,18.49,305,0
HYHG,304,0,0.00,0,0.00,60.27,304,0
XDQQ,301,0,0.00,0,0.00,24.78,301,0
FFTG,300,0,0.00,0,0.00,24.69,300,0
KCAL,300,0,0.00,0,0.00,23.42,300,0
KWT,300,0,0.00,0,0.00,31.34,300,0
PSMO,300,0,0.00,0,0.00,22.99,300,0
SANE,300,0,0.00,0,0.00,24.97,300,0
FFEB,294,0,0.00,0,0.00,38.88,294,0
BLDG,283,0,0.00,0,0.00,24.86,283,0
FFTI,279,0,0.00,0,0.00,20.55,279,0
TILT,279,0,0.00,0,0.00,163.76,279,0
CAOS,261,0,0.00,0,0.00,80.19,261,0
RPHS,260,0,0.00,0,0.00,8.66,260,0
PBTP,250,0,0.00,0,0.00,24.80,250,0
GHYG,249,0,0.00,0,0.00,42.13,249,0
NOCT,243,0,0.00,0,0.00,41.17,243,0
FPRO,232,0,0.00,0,0.00,20.34,232,0
ADME,229,0,0.00,0,0.00,35.41,229,0
IYLD,227,0,0.00,0,0.00,19.31,227,0
VFMV,222,0,0.00,0,0.00,99.74,222,0
BJUN,208,0,0.00,0,0.00,32.65,208,0
GLDB,206,0,0.00,0,0.00,20.20,206,0
GEMD,204,0,0.00,0,0.00,39.89,204,0
ESGG,202,0,0.00,0,0.00,137.87,202,0
MOTG,201,0,0.00,0,0.00,34.13,1,200
IMFL,200,0,0.00,0,0.00,23.81,200,0
LEAD,200,0,0.00,0,0.00,53.43,200,0
TFJL,200,0,0.00,0,0.00,20.37,200,0
HAUS,197,0,0.00,0,0.00,16.16,197,0
DSCF,195,0,0.00,0,0.00,21.81,195,0
TOKE,188,0,0.00,0,0.00,5.77,188,0
RESE,181,0,0.00,0,0.00,28.82,181,0
DUSA,180,0,0.00,0,0.00,31.09,180,0
JUNZ,178,0,0.00,0,0.00,25.59,178,0
ACSI,175,0,0.00,0,0.00,45.70,175,0
VFMO,175,0,0.00,0,0.00,117.20,175,0
BGLD,174,0,0.00,0,0.00,20.05,174,0
EMTL,169,0,0.00,0,0.00,40.71,169,0
JBBB,150,0,0.00,0,0.00,45.52,150,0
MSVX,147,0,0.00,0,0.00,23.67,147,0
WUGI,147,0,0.00,0,0.00,46.19,147,0
VFQY,146,0,0.00,0,0.00,110.87,146,0
TMFS,144,0,0.00,0,0.00,27.65,144,0
DSEP,141,0,0.00,0,0.00,33.44,141,0
EWGS,140,0,0.00,0,0.00,60.08,140,0
BUFQ,137,0,0.00,0,0.00,24.60,137,0
XJR,137,0,0.00,0,0.00,34.67,137,0
EWUS,136,0,0.00,0,0.00,33.05,136,0
HYXU,131,0,0.00,0,0.00,46.55,131,0
FDHT,130,0,0.00,0,0.00,19.15,130,0
BOCT,129,0,0.00,0,0.00,35.47,129,0
DUDE,129,0,0.00,0,0.00,20.43,129,0
LJIM,121,0,0.00,0,0.00,25.79,121,0
FDEM,120,0,0.00,0,0.00,22.70,120,0
EMDV,111,0,0.00,0,0.00,46.45,111,0
IBML,110,0,0.00,0,0.00,25.43,110,0
PTEU,109,0,0.00,0,0.00,25.90,109,0
IEDI,107,0,0.00,0,0.00,38.39,107,0
TMDV,105,0,0.00,0,0.00,46.19,105,0
ROMO,102,0,0.00,0,0.00,25.40,102,0
VMOT,102,0,0.00,0,0.00,22.36,102,0
BLKC,100,0,0.00,0,0.00,11.60,100,0
MBND,100,0,0.00,0,0.00,26.77,100,0
MSMR,100,0,0.00,0,0.00,23.79,100,0
NOVZ,100,0,0.00,0,0.00,32.81,100,0
PSMD,100,0,0.00,0,0.00,24.01,100,0
RODE,100,0,0.00,0,0.00,26.08,100,0
KRUZ,97,0,0.00,0,0.00,24.73,97,0
LKOR,97,0,0.00,0,0.00,42.64,97,0
VEGN,96,0,0.00,0,0.00,37.50,95,1
UOCT,93,0,0.00,0,0.00,29.55,93,0
FDEV,90,0,0.00,0,0.00,25.95,90,0
DMAR,76,0,0.00,0,0.00,31.82,76,0
LCF,75,0,0.00,0,0.00,27.80,75,0
AUGZ,70,0,0.00,0,0.00,32.43,70,0
ZECP,64,0,0.00,0,0.00,24.28,64,0
QVOY,56,0,0.00,0,0.00,26.33,56,0
SEPZ,50,0,0.00,0,0.00,31.90,50,0
BAPR,46,0,0.00,0,0.00,34.83,46,0
DOCT,43,0,0.00,0,0.00,34.19,43,0
EGUS,43,0,0.00,0,0.00,29.12,43,0
GDMA,38,0,0.00,0,0.00,29.31,38,0
PBSM,34,0,0.00,0,0.00,32.08,34,0
RVRB,34,0,0.00,0,0.00,22.37,34,0
FMAR,29,0,0.00,0,0.00,34.94,29,0
ESHY,28,0,0.00,0,0.00,18.02,28,0
UNOV,27,0,0.00,0,0.00,30.22,27,0
ATMP,26,0,0.00,0,0.00,19.43,26,0
HEAT,26,0,0.00,0,0.00,26.11,26,0
ESEB,25,0,0.00,0,0.00,16.58,25,0
DFND,24,0,0.00,0,0.00,35.50,24,0
XDJL,21,0,0.00,0,0.00,27.52,21,0
EFNL,20,0,0.00,0,0.00,36.21,20,0
PIT,19,0,0.00,0,0.00,46.90,14,5
IVAL,18,0,0.00,0,0.00,23.57,18,0
EMGC,15,0,0.00,0,0.00,25.60,15,0
PSFM,14,0,0.00,0,0.00,23.86,14,0
GDE,13,0,0.00,0,0.00,24.93,13,0
IAUF,12,0,0.00,0,0.00,58.87,12,0
GDMN,11,0,0.00,0,0.00,25.60,11,0
STLV,11,0,0.00,0,0.00,26.98,11,0
GHTA,10,0,0.00,0,0.00,25.62,10,0
XTOC,10,0,0.00,0,0.00,23.92,10,0
HCRB,8,0,0.00,0,0.00,34.60,8,0
DFHY,7,0,0.00,0,0.00,20.56,7,0
NUDV,7,0,0.00,0,0.00,23.62,7,0
UJAN,6,0,0.00,0,0.00,32.15,6,0
IBHI,5,0,0.00,0,0.00,22.13,5,0
IPDP,5,0,0.00,0,0.00,15.72,5,0
IVRA,4,0,0.00,0,0.00,13.17,4,0
MBBB,4,0,0.00,0,0.00,20.65,4,0
PSMM,4,0,0.00,0,0.00,13.74,4,0
CLSE,3,0,0.00,0,0.00,15.29,3,0
DWAT,3,0,0.00,0,0.00,10.16,3,0
TSLH,3,0,0.00,0,0.00,26.60,3,0
XBJL,3,0,0.00,0,0.00,28.72,3,0
BRLN,2,0,0.00,0,0.00,51.69,2,0
GJAN,2,0,0.00,0,0.00,32.00,2,0
HELX,2,0,0.00,0,0.00,30.31,2,0
IPPP,2,0,0.00,0,0.00,9.28,2,0
KOCT,2,0,0.00,0,0.00,26.82,2,0
MBNE,2,0,0.00,0,0.00,29.27,2,0
NJAN,2,0,0.00,0,0.00,39.52,2,0
PSMC,2,0,0.00,0,0.00,12.17,2,0
QPFF,2,0,0.00,0,0.00,35.32,2,0
QTJA,2,0,0.00,0,0.00,20.11,2,0
SNPG,2,0,0.00,0,0.00,30.72,2,0
TBJL,2,0,0.00,0,0.00,20.41,2,0
XBOC,2,0,0.00,0,0.00,25.50,2,0
XTJA,2,0,0.00,0,0.00,22.53,2,0
YSEP,2,0,0.00,0,0.00,19.73,2,0
AFIF,1,0,0.00,0,0.00,8.82,1,0
APRD,1,0,0.00,0,0.00,25.25,1,0
BBSA,1,0,0.00,0,0.00,47.17,1,0
BEMB,1,0,0.00,0,0.00,50.41,1,0
DOGG,1,0,0.00,0,0.00,19.93,1,0
EAOK,1,0,0.00,0,0.00,24.16,1,0
EVUS,1,0,0.00,0,0.00,24.10,1,0
FLTN,1,0,0.00,0,0.00,21.18,1,0
ISVL,1,0,0.00,0,0.00,31.75,1,0
MAAX,1,0,0.00,0,0.00,20.60,1,0
MAMB,1,0,0.00,0,0.00,22.13,1,0
MIG,1,0,0.00,0,0.00,20.65,1,0
OBND,1,0,0.00,0,0.00,25.48,1,0
PSMB,1,0,0.00,0,0.00,14.91,1,0
WBAT,1,0,0.00,0,0.00,34.13,1,0
WDNA,1,0,0.00,0,0.00,17.91,1,0
YJUN,1,0,0.00,0,0.00,20.20,1,0
ADFI,0,0,0.00,0,0.00,0.00,0,0
APRQ,0,0,0.00,0,0.00,0.00,0,0
APRZ,0,0,0.00,0,0.00,0.00,0,0
ARCM,0,0,0.00,0,0.00,0.00,0,0
BBEM,0,0,0.00,0,0.00,0.00,0,0
BBIB,0,0,0.00,0,0.00,0.00,0,0
BBIP,0,0,0.00,0,0.00,0.00,0,0
BBLB,0,0,0.00,0,0.00,0.00,0,0
BBSB,0,0,0.00,0,0.00,0.00,0,0
BKGI,0,0,0.00,0,0.00,0.00,0,0
BOSS,0,0,0.00,0,0.00,0.00,0,0
CFCV,0,0,0.00,0,0.00,0.00,0,0
CVAR,0,0,0.00,0,0.00,0.00,0,0
DBJA,0,0,0.00,0,0.00,0.00,0,0
DBOC,0,0,0.00,0,0.00,0.00,0,0
DECZ,0,0,0.00,0,0.00,0.00,0,0
DKRB,0,0,0.00,0,0.00,0.00,0,0
DSJA,0,0,0.00,0,0.00,0.00,0,0
DSOC,0,0,0.00,0,0.00,0.00,0,0
DWCR,0,0,0.00,0,0.00,0.00,0,0
EAOM,0,0,0.00,0,0.00,0.00,0,0
EAOR,0,0,0.00,0,0.00,0.00,0,0
EMCA,0,0,0.00,0,0.00,0.00,0,0
EMCH,0,0,0.00,0,0.00,0.00,0,0
EMPW,0,0,0.00,0,0.00,0.00,0,0
EMZA,0,0,0.00,0,0.00,0.00,0,0
ESCR,0,0,0.00,0,0.00,0.00,0,0
EUDV,0,0,0.00,0,0.00,0.00,0,0
FAIL,0,0,0.00,0,0.00,0.00,0,0
FEBZ,0,0,0.00,0,0.00,0.00,0,0
FLDZ,0,0,0.00,0,0.00,0.00,0,0
FLQS,0,0,0.00,0,0.00,0.00,0,0
FPAG,0,0,0.00,0,0.00,0.00,0,0
FUNL,0,0,0.00,0,0.00,0.00,0,0
GCLN,0,0,0.00,0,0.00,0.00,0,0
GPAL,0,0,0.00,0,0.00,0.00,0,0
GSEE,0,0,0.00,0,0.00,0.00,0,0
GSID,0,0,0.00,0,0.00,0.00,0,0
HEET,0,0,0.00,0,0.00,0.00,0,0
HIYS,0,0,0.00,0,0.00,0.00,0,0
HSUN,0,0,0.00,0,0.00,0.00,0,0
IBMR,0,0,0.00,0,0.00,0.00,0,0
ICLO,0,0,0.00,0,0.00,0.00,0,0
IMSI,0,0,0.00,0,0.00,0.00,0,0
ISDB,0,0,0.00,0,0.00,0.00,0,0
JANZ,0,0,0.00,0,0.00,0.00,0,0
KJUL,0,0,0.00,0,0.00,0.00,0,0
MARZ,0,0,0.00,0,0.00,0.00,0,0
MBCC,0,0,0.00,0,0.00,0.00,0,0
MINN,0,0,0.00,0,0.00,0.00,0,0
MOTE,0,0,0.00,0,0.00,0.00,0,0
MRGR,0,0,0.00,0,0.00,0.00,0,0
MSTQ,0,0,0.00,0,0.00,0.00,0,0
NULC,0,0,0.00,0,0.00,0.00,0,0
OCTZ,0,0,0.00,0,0.00,0.00,0,0
PBDM,0,0,0.00,0,0.00,0.00,0,0
PBL,0,0,0.00,0,0.00,0.00,0,0
PLRG,0,0,0.00,0,0.00,0.00,0,0
PLTL,0,0,0.00,0,0.00,0.00,0,0
PSCJ,0,0,0.00,0,0.00,0.00,0,0
PSCQ,0,0,0.00,0,0.00,0.00,0,0
PSCW,0,0,0.00,0,0.00,0.00,0,0
PSCX,0,0,0.00,0,0.00,0.00,0,0
PSFD,0,0,0.00,0,0.00,0.00,0,0
PSFO,0,0,0.00,0,0.00,0.00,0,0
PSMR,0,0,0.00,0,0.00,0.00,0,0
PXUS,0,0,0.00,0,0.00,0.00,0,0
QCON,0,0,0.00,0,0.00,0.00,0,0
QTAP,0,0,0.00,0,0.00,0.00,0,0
QTJL,0,0,0.00,0,0.00,0.00,0,0
QTOC,0,0,0.00,0,0.00,0.00,0,0
RDFI,0,0,0.00,0,0.00,0.00,0,0
ROCI,0,0,0.00,0,0.00,0.00,0,0
RYSE,0,0,0.00,0,0.00,0.00,0,0
SEIM,0,0,0.00,0,0.00,0.00,0,0
SEIQ,0,0,0.00,0,0.00,0.00,0,0
SEIV,0,0,0.00,0,0.00,0.00,0,0
SELV,0,0,0.00,0,0.00,0.00,0,0
SFIG,0,0,0.00,0,0.00,0.00,0,0
SHDG,0,0,0.00,0,0.00,0.00,0,0
SMI,0,0,0.00,0,0.00,0.00,0,0
SNPD,0,0,0.00,0,0.00,0.00,0,0
SNPV,0,0,0.00,0,0.00,0.00,0,0
SUPP,0,0,0.00,0,0.00,0.00,0,0
TOLL,0,0,0.00,0,0.00,0.00,0,0
TUSI,0,0,0.00,0,0.00,0.00,0,0
VIRS,0,0,0.00,0,0.00,0.00,0,0
VWID,0,0,0.00,0,0.00,0.00,0,0
WFIG,0,0,0.00,0,0.00,0.00,0,0
XDAP,0,0,0.00,0,0.00,0.00,0,0
XDAT,0,0,0.00,0,0.00,0.00,0,0
XDJA,0,0,0.00,0,0.00,0.00,0,0
XDOC,0,0,0.00,0,0.00,0.00,0,0
XEMD,0,0,0.00,0,0.00,0.00,0,0
XTAP,0,0,0.00,0,0.00,0.00,0,0
XVOL,0,0,0.00,0,0.00,0.00,0,0
YDEC,0,0,0.00,0,0.00,0.00,0,0
YPS,0,0,0.00,0,0.00,0.00,0,0